                                                                      ‡                                                                      
                                                                      .                                                                      
                                                                     ...                                                                     
                                                                       ..                                                                    
                                                                      ..                                                                     
                                              .                       X           .                                                          
                                  .            .                     ....         ..          .                   .                          
                                ....           .            .........................        ...                 ..                          
                  .          ........        ..      ...............................................            ...                          
                  ..      ..............................................................................   .   ....                         
              ............................................................................................... ..............                 
               ............................................................................................................                  
                ..........................................................................................................                   
                 ........................................................................................................                    
            ..................................................................................................................               
                .............................................................................................................                
        .........................................................................................................................            
           ..................................................................................................................                
         .......................................................................................................................             
   .   ............................................................................................................................     ...  
%.... ............................................................................................................................... ... ..&
    ... ......................................................................................................................      ...      
           ......................................................................................................................            
            ........................................................................................................................         
           ..................................................................................................................                
             ...................................................................................................................             
               ..............................................................................................................                
         ..........................................................................................................................          
           ...       ............................................................................................................            
            .     ..........................................................................................................                 
                   ..  .......................................................................................................               
                  ..     ..       .............................................................   ...   ...............                      
                  .      .         ............ ....... ................................     ..    .    .   .....                            
                  .       .             ..   .    ...      .      ...................        .     .    .     ..                             
                                         .   .    ..       .          ..                     .          .     .                              
                                         .        ..                  X                                 .                                    
                                                  .                  ..                                 .                                    
                                                  .                   ...                                                                    
                                                                       ..                                                                    
                                                                       .                                                                     
                                                                       §                                                                     