                                                                      Ω                                                                      
                                                                      .                                                                      
                                                                     ...                                                                     
                                                                       ..                                                                    
                                                                      ..                                                                     
                                              .                       X           .                                                          
                                  .            .                     ....         ..          .                   .                          
                                ....           .            .........................        ...                 ..                          
                  .          ........        ..      ...............................................            ...                          
                  ..      ..............................................................................   .   ....                          
             ...............................................................................................................                 
              .............................................................................................................                  
               ...........................................................................................................                   
                .........................................................................................................                    
             .................................................................................................................               
              ...............................................................................................................                
         ........................................................................................................................            
            .................................................................................................................                
          ......................................................................................................................             
   .    ...........................................................................................................................     ...  
&.... ............................................................................................................................... ... ..?
    ...  .....................................................................................................................      ...      
            .....................................................................................................................            
             .......................................................................................................................         
            .................................................................................................................                
              ..................................................................................................................             
                .............................................................................................................                
          .........................................................................................................................          
            ...  ................................................................................................................            
             .    ..........................................................................................................                 
                   ...........................................................................................................               
                  ..     ..       .....................................................................................                      
                  .      .          ............ ................................................  .    .   .....                            
                  .       .             ..   .    .............................................    .    .     ..                             
                                         .   .    ..       .          X                      .          .     .                              
                                         .        ..       .          X                      .          .                                    
                                                  .                  ..                      .          .                                    
                                                  .                   ...                                                                    
                                                                       ..                                                                    
                                                                       .                                                                     
                                                                       ‡                                                                     