                                                                     @                                                                      
                                                                     .                                                                      
                                                                    ..                                                                      
                                                                     ...                                                                    
                                                                       ..                                        .                          
                                                                        X                                       ..                          
                                                                      ....                   .                 ...                          
                                                           .........................        ...                ...                          
                  .                   .............................................................            ...                          
                  ..      .............................................................................       .............                 
              ..........................................................................................................                    
               .................................................................................................                            
                ...............................................................................................................             
                 .............................................................................................................              
            .................................................................................................................               
        ....................................................................................................................                
        ........................................................................................................................            
        .......................................................................................................................             
   .   ...........................................................................................................................     ...  
%.... .................................................................................................................................. ..#
    ... .....................................................................................................................               
           .....................................................................................................................            
            .......................................................................................................................         
           .................................................................................................................                
             ..................................................................................................................             
               .............................................................................................................                
         .........................................................................................................................          
           ...           .......................................................................................................            
            .     ...............................................................................................................           
                      ......................................................................................................                
                         ..       ............................................................         ...............                      
                         .         ....................................................                    .....                            
                          .                                      ...................                         ..                             
                                                                     ..                                      .                              
                                                                     X                                                                      
                                                                    ..                                                                      
                                                                     ...                                                                    
                                                                      ..                                                                    
                                                                      .                                                                     
                                                                      $                                                                     